The Phantasmagoria Game. This is the story of Adrienne, a writer who moves with you husband Don into a remote mansion and finds herself terrorized by supernatural forces. After a month in the mansion Adrienne's husband is possessed. Now she needs to escape immediately from the mansion and find help outside.

Phantasmagoria
An Interactive Fiction by Fernando Novaes
Release 1 / Serial number 200712 / Inform 7 build 6M62 (I6/v6.33 lib 6/12N) SD

kitchen
You are seated at the table in the kitchen. Looking around You see some old fashioned furniture. You are exhausted, tired and thinking how to escape from the mansion using a secret way.

You can see a drawer (closed), a food pantry entrance on north, and a diner entrance on south here.

>find
That's not a verb I recognise.

>find
That's not a verb I recognise.

>look
Kitchen
You are seated at the table and The kitchen is very large with some old fashioned furniture.

You find a Matchbox.

* * *

>look
Kitchen
You are seated at the table and The kitchen is very large with some old fashioned furniture.

You find a Matchbox.

* * *

I beg your pardon?

* * *

>go to Food Pantry
You can't see any such thing.

>go to
You can't see any such thing.

* * *

>go
You'll have to say which compass direction to go in.

>go to north
You can't see any such thing.

>n
Food Pantry
The Food Pantry is tight and has a closet and a red carpet on the floor.

* * *

>go north
Food Pantry
The Food Pantry is tight and has a closet and a red carpet on the floor. There is something under the carpet.

>dresser
That's not a verb I recognise.

>find
That's not a verb I recognise.

>open
What do you want to open?

>dresser
You can't see any such thing.

* * *

>go north
Food Pantry
The Food Pantry is tight and has a closet and a red carpet on the floor. There is something under the carpet.

>go south
Kitchen
You are seated at the table and The kitchen is very large with some old fashioned furniture.

>go dresser
You can't see any such thing.

>see
That's not a verb I recognise.

>to see
That's not a verb I recognise.

>in there
I only understood you as far as wanting to (go) in.

>go dresser
You can't see any such thing.

>go Dresser
You can't see any such thing.

* * *

>go north
Food Pantry
The Food Pantry is tight and has a closet and a red carpet on the floor. There is something under the carpet.

>look the carpet
You can't see any such thing.

* * *

>go north
Food Pantry
The Food Pantry is tight and has a closet and a red carpet on the floor. There is something under the carpet.

>look inside
You see nothing unexpected in that direction.

>carpet
That's not a verb I recognise.

>look the carpet
You can't see any such thing.

* * *

>look inside
You see nothing unexpected in that direction.

>look under the carpet
You can't see any such thing.

>go south
Kitchen
You are seated at the table and The kitchen is very large with some old fashioned furniture.

>go south
Dresser
There are 3 drawers.

You picked up the Matchbox.

* * *

>go north
Food Pantry
The Food Pantry is tight and has a closet and a red carpet on the floor. There is something under the carpet.

>look under
What do you want to look under?

>carpet
You can't see any such thing.

* * *

>go north
Food Pantry
The Food Pantry is tight and has a closet and a red carpet on the floor. There is something under the carpet.

>go under
You can't see any such thing.

>look under
What do you want to look under?

* * *

>carpet
You can't see any such thing.

>new route
That's not a verb I recognise.

>contais
That's not a verb I recognise.

>contains
That's not a verb I recognise.

>carpet
That's not a verb I recognise.

>open carpet
You can't see any such thing.

>open
What do you want to open?

>carpet
You can't see any such thing.

>cear
That's not a verb I recognise.

>clear
What do you want to clear?

>root
You can't see any such thing.

* * *

>go north
Food Pantry
The Food Pantry is tight and has a closet and a red carpet on the floor. There is something under the carpet.

>look
Food Pantry
The Food Pantry is tight and has a closet and a red carpet on the floor.

>move
What do you want to move?

>carpet
You can't see any such thing.

* * *

>look
Food Pantry
The Food Pantry is tight and has a closet and a red carpet on the floor.

>look the carpet
You can't see any such thing.

>look carpet
You can't see any such thing.

* * *

>look
Food Pantry
The Food Pantry is tight and has a closet and a red carpet on the floor.

>look under
What do you want to look under?

* * *

>go north
Food Pantry
The Food Pantry is tight and has a closet and a red carpet on the floor. There is something under the carpet.

>look floor
You can't see any such thing.

>look the floor
You can't see any such thing.

>look on the floor
You can't see any such thing.

>look the carpet
You can't see any such thing.

* * *

>look floor
You can't see any such thing.

>look
Food Pantry
The Food Pantry is tight and has a closet and a red carpet on the floor.

>look to
You can't see any such thing.

>look at
What do you want to look at?

>floor
You can't see any such thing.

>look at
What do you want to look at?

>food psntry
You can't see any such thing.

>look at
What do you want to look at?

>food pantry
You can't see any such thing.

* * *

>go north
Food Pantry
The Food Pantry is tight and has a closet and a red carpet on the floor. There is something under the carpet.

>look at
What do you want to look at?

>carpet
You can't see any such thing.

>look at
What do you want to look at?

* * *

>floor
You can't see any such thing.

>go floor
You can't see any such thing.

>move
What do you want to move?

* * *

>go north
Food Pantry
The Food Pantry is tight and has a closet and a red carpet on the floor. There is something under the carpet.

>examine
What do you want to examine?

>carpet
You can't see any such thing.

* * *

>go south
Dresser
There are 3 drawers. You should open it.

You can see Drawers here.

>open
(Drawers)
You find a Matchbox.

>open dresser
You can't see any such thing.

>see dresser
That's not a verb I recognise.

>look dresser
You can't see any such thing.

* * *

>open
(Drawers)
You find a Matchbox.

>open first
You can't see any such thing.

>open first drawer
You can't see any such thing.

>first drawer
That's not a verb I recognise.

>look first drawer
You can't see any such thing.

* * *

>open
(Drawers)
You find a Matchbox.

>drawer
You can't see any such thing.

>open dresser
You can't see any such thing.

* * *

>drawer
You can't see any such thing.

>dresser
That's not a verb I recognise.

>open dresser
You can't see any such thing.

* * *

>drawer
You can't see any such thing.

>open
What do you want to open?

>,dresser
You can't begin with a comma.

>dresser
That's not a verb I recognise.

* * *

>open
(Drawers)
You find a Matchbox.

>go north
Kitchen
You are seated at the table and The kitchen is very large with some old fashioned furniture.

>go north
Food Pantry
The Food Pantry is tight and has a closet and a red carpet on the floor.

>move
What do you want to move?

* * *

>go south
Dresser
There are 3 drawers. You should open it.

You can see Drawers here.

>contain
That's not a verb I recognise.

>contains
That's not a verb I recognise.

>first drawer
That's not a verb I recognise.

>open first drawer
You can't see any such thing.

>is first drawer
That's not a verb I recognise.

* * *

>go south
Dresser
There are 3 drawers. You should open it.

You can see Drawers here.

>open first drawer
You can't see any such thing.

>conatin first drawer
That's not a verb I recognise.

>find first drawer
That's not a verb I recognise.

>is first drawer
That's not a verb I recognise.

>go first drawer
You can't see any such thing.

* * *

>go south
Dresser
There are 3 drawers. You should open it.

You can see Drawers here.

>open the drawer
You can't see any such thing.

>open
What do you want to open?

>drawer
You can't see any such thing.

* * *

>dresser
That's not a verb I recognise.

>open the dresser
You can't see any such thing.

>look inside
You see nothing unexpected in that direction.

>look inside the drawer
You can't see any such thing.

>go drawer
You can't see any such thing.

>go north
Kitchen
You are seated at the table and The kitchen is very large with some old fashioned furniture.

* * *

>go north
Food Pantry
The Food Pantry is tight and has a closet and a red carpet on the floor.

>look
Food Pantry
The Food Pantry is tight and has a closet and a red carpet on the floor.

* * *

>go north[
You can't see any such thing.

>go north
Food Pantry
The Food Pantry is tight and has a closet and a red carpet on the floor.

>under
That's not a verb I recognise.

>look under
What do you want to look under?

* * *

>go  orth
You can't see any such thing.

>go north
Food Pantry
The Food Pantry is tight and has a closet and a red carpet on the floor.

* * *

>look
Food Pantry
The Food Pantry is tight and has a closet and a red carpet on the floor.

>look on thr floor
You can't see any such thing.

>floor
That's not a verb I recognise.

>look floor
You can't see any such thing.

>look on the floor
You can't see any such thing.

>flor
That's not a verb I recognise.

>see
That's not a verb I recognise.

>open
What do you want to open?

>floor
You can't see any such thing.

* * *

>n
Food Pantry
The Food Pantry is tight and has a closet and a red carpet on the floor. There is something under the carpet, You should examine it.

You can see a Carpet and a Closet here.

>look
Food Pantry
The Food Pantry is tight and has a closet and a red carpet on the floor. There is something under the carpet.

You can see a Carpet and a Closet here.

>move
What do you want to move?

>carpet
Nothing obvious happens.

>examine
What do you want to examine?

>carpet
You found a sercret way.

* * *

>n
Food Pantry
The Food Pantry is tight and has a closet and a red carpet on the floor. There is something under the carpet, You should examine it.

You can see a Carpet and a Closet here.

>examine
What do you want to examine?

>carpet
You found a sercret way, but it is locked. You need something to open it.

>s
Kitchen
You are seated at the table and The kitchen is very large with some old fashioned furniture.

You can see a Brown Door here.

>w
Dresser
There are 3 drawers. You should open it.

You can see Drawers here.

>examine
(Drawers)
You found a sercret way, but it is locked. You need something to open it.

>open
(Drawers)
You found a Matchbox.

* * *

>carpet
You found a sercret way, but it is locked. You need something to open it.

>n
You can't go that way.

>s
Kitchen
You are seated at the table and The kitchen is very large with some old fashioned furniture.

You can see a Brown Door here.

* * *

>n
Food Pantry
The Food Pantry is tight and has a closet and a red carpet on the floor. There is something under the carpet, You should examine it.

You can see a Carpet and a Closet here.

>examine carpet
You found a sercret way, but it is locked. You need something to open it.

>s
Kitchen
You are seated at the table and The kitchen is very large with some old fashioned furniture.

You can see a Drawer (in which is a Matchbox) here.

>open
(the Drawer)
You found a Matchbox. It will be useful in another moment.

>s
Living Room
Now you are entering in the living room. Although there are six large windows, the room is kind of dark. There is a long table, a huge mirror and a lit fireplace. You should examine those.

You can see a Fire Place, a Huge Mirror and a Long Table here.

>examine fireplace
You can't see any such thing.

>examine lit fireplace
You can't see any such thing.

>examine huge mirror
You found a sercret way, but it is locked. You need something to open it.

* * *

>s
diner
Now you are entering in the dinner room. Although there are six large windows, the room is kind of dark. There is a long table, a huge mirror and a fireplace. You should examine those.

You can see a huge mirror, a long table, a fireplace (in which is a Fireplace Tool), and a piano room entrance on west here.

>s
(first opening the Brown Door)
You found a Matchbox.

* * *

>s
diner
Now you are entering in the dinner room. Although there are six large windows, the room is kind of dark. There is a long table, a huge mirror and a fireplace. You should examine those.

You can see a huge mirror, a long table, a fireplace (in which is a Fireplace Tool), and a piano room entrance on west here.

>n
Food Pantry
The Food Pantry is tight and has a closet and a red carpet on the floor. There is something under the carpet.

You can see a carpet and a Closet here.

* * *

>s
diner
Now you are entering in the dinner room. Although there are six large windows, the room is kind of dark. There is a long table, a huge mirror and a fireplace. You should examine those.

You can see a huge mirror, a long table, a fireplace (in which is a Fireplace Tool), and a piano room entrance on west here.

>w
You bumped into Don... He is nervous, has red eyes and is angry. You should talk to Don.

piano room
The piano room is large, sort of dark, old fashioned sofas around the piano and some equipment for magician on the corners of the room.

You can see Don here.

>n
You can't go that way.

>s
You can't go that way.

>w
You can't go that way.

>e
diner
Now you are entering in the dinner room. Although there are six large windows, the room is kind of dark. There is a long table, a huge mirror and a fireplace. You should examine those.

You can see a huge mirror, a long table, a fireplace (in which is a Fireplace Tool), and a piano room entrance on west here.

>w
piano room
The piano room is large, sort of dark, old fashioned sofas around the piano and some equipment for magician in the corners of the room.

>e
diner
Now you are entering in the dinner room. Although there are six large windows, the room is kind of dark. There is a long table, a huge mirror and a fireplace. You should examine those.

You can see a huge mirror, a long table, a fireplace (in which is a Fireplace Tool), and a piano room entrance on west here.

>n
kitchen
You are seated at the table in the kitchen. Looking around You see some old fashioned furniture. You are exhausted, tired and thinking how to escape from the mansion using a secret way.

You can see a drawer (closed), a food pantry entrance on north, and a diner entrance on south here.

>n
food pantry
The Food Pantry is tight and has a closet and a red carpet on the floor. There is something under the carpet, You should examine it.

You can see a carpet and a closet here.

>s
kitchen
You are seated at the table in the kitchen. Looking around You see some old fashioned furniture. You are exhausted, tired and thinking how to escape from the mansion using a secret way.

You can see a drawer (closed), a food pantry entrance on north, and a diner entrance on south here.

>s
diner
Now you are entering in the dinner room. Although there are six large windows, the room is kind of dark. There is a long table, a huge mirror and a fireplace. You should examine those.

You can see a huge mirror, a long table, a fireplace (in which is a Fireplace Tool), and a piano room entrance on west here.

* * *

>w
You bumped into Don... He is nervous, has red eyes and is angry. You should talk to Don.

piano room
The piano room is large, sort of dark, old fashioned sofas around the piano and some equipment for magician on the corners of the room.

You can see Don here.

>what
That's not a verb I recognize.

>enter
You must supply a noun.

>enter piano room
You can't see any such thing.

>do
That's not a verb I recognize.

* * *

>w
You bumped into Don... He is nervous, has red eyes and is angry. You should talk to Don.

piano room
The piano room is large, sort of dark, old fashioned sofas around the piano and some equipment for magician on the corners of the room.

You can see Don here.

I beg your pardon?

>enter
You must supply a noun.

>go
You'll have to say which compass direction to go in.

>s
You can't go that way.

>n
You can't go that way.

>e
diner
Now you are entering in the dinner room. Although there are six large windows, the room is kind of dark. There is a long table, a huge mirror and a fireplace. You should examine those.

You can see a huge mirror, a long table, a fireplace (in which is a Fireplace Tool), and a piano room entrance on west here.

>go w
piano room
The piano room is large, sort of dark, old fashioned sofas around the piano and some equipment for magician on the corners of the room.

* * *

>w
You bumped into Don... He is nervous, has red eyes and is angry. You should talk to Don.

piano room
The piano room is large, sort of dark, old fashioned sofas around the piano and some equipment for magician on the corners of the room.

You can see Don here.

>talk
(to yourself)
You doesn't reply.

>talk to Don
You can't see any such thing.

>talk
(to yourself)
You doesn't reply.

>talk Don
I didn't understand that sentence.

>talking
That's not a verb I recognize.

>talk to Don
You can't see any such thing.

* * *

>w
You bumped into Don... He is nervous, has red eyes and is angry. You should talk to Don.

piano room
The piano room is large, sort of dark, old fashioned sofas around the piano and some equipment for magician on the corners of the room.

You can see Don here.

>talk to Don
I will take you to.... Follow me now... I will take You to... I don't need to explain.Come on! 

Do You follow him or push him?

>follow
(Don)
You shouldn't have done it!!!

    *** Mission Failed! ***

Would you like to RESTART, RESTORE a saved game, QUIT, or UNDO the last command?

* * *

>talk to Don
I will take you to.... Follow me now... I will take You to... I don't need to explain.Come on! 

Do You follow him or push him?

>stop
That's not a verb I recognize.

* * *

>talk to Don
I will take you to.... Follow me now... I will take You to... I don't need to explain.Come on! 

Do You follow him or push him?

>push
(Don)
Don fell down and seems to be passed out... run! Its time to run away.

You climbed up the stairs to second floor. Now You are in the middle of the hallway with 6 doors, none of them is opened.

When You turned around, You tripped over on a candle lantern.

hallway
The hallway has six rooms and candle lanterns on the wall.

You can see a candle lantern here.

>take
(the candle lantern)
Now You have everything to escape.

You are going down the stairs slowly worried about Don, but He is not here any more. Now You are on first floor, look for the secret way to go outside of the mansion.

piano room
The piano room is large, sort of dark, old fashioned sofas around the piano and some equipment for magician on the corners of the room.

Taken.

>e
Don found You. He is possessed by Mr. Carmo...  You should avoid him!!!

    *** By the time, you should have already taken all objects to escape. Mission Failed! ***

Would you like to RESTART, RESTORE a saved game, QUIT, or UNDO the last command?

* * *

>w
You bumped into Don... He is nervous, has red eyes and is angry. You should talk to Don.

piano room
The piano room is large, sort of dark, old fashioned sofas around the piano and some equipment for magician on the corners of the room.

You can see Don here.

>Don
(Don)
(first taking Don)
I don't suppose Don would care for that.

>talk to Don
I will take you to.... Follow me now. I don't need to explain!

* * *

>w
You bumped into Don... He is nervous, has red eyes and is angry. You should talk to Don.

piano room
The piano room is large, sort of dark, old fashioned sofas around the piano and some equipment for magician on the corners of the room.

You can see Don here.

>follow
(Don)
Don follow who?

* * *

>w
You bumped into Don... He is nervous, has red eyes and is angry. You should talk to Don.

piano room
The piano room is large, sort of dark, old fashioned sofas around the piano and some equipment for magician on the corners of the room.

You can see Don here.

>push him
I'm not sure what 'him' refers to.

>push Don
Don might not like that.

>push Don
Don might not like that.

* * *

>w
You bumped into Don... He is nervous, has red eyes and is angry. You should talk to Don.

piano room
The piano room is large, sort of dark, old fashioned sofas around the piano and some equipment for magician on the corners of the room.

You can see Don here.

>push Don
Don fell down... run!

Don might not like that.

>n
You can't go that way.

* * *

>s
You can't go that way.

>e
diner
Now you are entering in the dinner room. Although there are six large windows, the room is kind of dark. There is a long table, a huge mirror and a fireplace. You should examine those.

You can see a huge mirror, a long table, a fireplace (in which is a Fireplace Tool), and a piano room entrance on west here.

>s
You can't go that way.

>n
kitchen
You are seated at the table in the kitchen. Looking around You see some old fashioned furniture. You are exhausted, tired and thinking how to escape from the mansion using a secret way.

You can see a drawer (closed), a food pantry entrance on north, and a diner entrance on south here.

* * *

>n
food pantry
The Food Pantry is tight and has a closet and a red carpet on the floor. There is something under the carpet, You should examine it.

You can see a carpet and a closet here.

>examine
What do you want to examine?

>carpet
You found a sercret way, but the secret access to go through is locked. You need something to open it.

You see nothing special about the carpet.

* * *

>w
You bumped into Don... He is nervous, has red eyes and is angry. You should talk to Don.

piano room
The piano room is large, sort of dark, old fashioned sofas around the piano and some equipment for magician on the corners of the room.

You can see Don here.

>push
(Don)
Don might not like that.

>pushing
That's not a verb I recognize.

>push to
You can't see any such thing.

>push to Don
You can't see any such thing.

>push
(Don)
Don might not like that.

* * *

>w
You bumped into Don... He is nervous, has red eyes and is angry. You should talk to Don.

piano room
The piano room is large, sort of dark, old fashioned sofas around the piano and some equipment for magician on the corners of the room.

You can see Don here.

>talk to don
I will take you to.... Follow me now... I will take You to... I don't need to explain.Come on! 

Do You follow him or push him?

>follow
(Don)
Don is possessed by Mr. Carmo... You shouldn't have done it!!!

    *** Mission Failed! ***

Would you like to RESTART, RESTORE a saved game, QUIT, or UNDO the last command?

>UNDO
piano room
[Previous turn undone.]

>w
You can't go that way.

* * *

>talk to don
I will take you to.... Follow me now... I will take You to... I don't need to explain.Come on! 

Do You follow him or push him?

>push
(Don)
Don fell down and seems to be passed out... run! Its time to run away.

You climbed up the stairs to second floor. Now You are in the middle of the hallway with 6 doors, none of them is opened.

When You turned around, You tripped over on a candle lantern.

hallway
The hallway has six rooms and candle lanterns on the wall.

You can see a candle lantern here.

>take
(the candle lantern)
Now You have everything to escape.

You are going down the stairs slowly worried about Don, but He is not here any more. Now You are on first floor, look for the secret way to go outside of the mansion.

piano room
The piano room is large, sort of dark, old fashioned sofas around the piano and some equipment for magician on the corners of the room.

You can see Don here.

Taken.

>examine
(the candle lantern)
You see nothing special about the candle lantern.

* * *

>take
(the candle lantern)
Now You have everything to escape.

You are going down the stairs slowly worried about Don, but He is not here any more. Now You are on first floor, look for the secret way to go outside of the mansion.

piano room
The piano room is large, sort of dark, old fashioned sofas around the piano and some equipment for magician on the corners of the room.

You can see Don here.

Taken.

>go down
You can't go that way.

>go first floor
You can't see any such thing.

* * *

>take
(the candle lantern)
Now You have everything to escape.

You are going down the stairs slowly worried about Don, but He is not here any more. Now You are on first floor, look for the secret way to go outside of the mansion.

piano room
The piano room is large, sort of dark, old fashioned sofas around the piano and some equipment for magician on the corners of the room.

You can see Don here.

Taken.

>e
diner
Now you are entering in the dinner room. Although there are six large windows, the room is kind of dark. There is a long table, a huge mirror and a fireplace. You should examine those.

You can see a huge mirror, a long table, a fireplace (in which is a Fireplace Tool), and a piano room entrance on west here.

* * *

>n
kitchen
You are seated at the table in the kitchen. Looking around You see some old fashioned furniture. You are exhausted, tired and thinking how to escape from the mansion using a secret way.

You can see a drawer (closed), a food pantry entrance on north, and a diner entrance on south here.

>open
(the candle lantern)
It isn't something you can open.

>open drawer
You found a matchbox. It will be useful in another moment.

You open the drawer.

>n
food pantry
The Food Pantry is tight and has a closet and a red carpet on the floor. There is something under the carpet, You should examine it.

You can see a carpet and a closet here.

* * *

>carpet
You found a sercret way, but the secret access to go through is locked. You need something to open it.

You see nothing special about the carpet.

>s
kitchen
You are seated at the table in the kitchen. Looking around You see some old fashioned furniture. You are exhausted, tired and thinking how to escape from the mansion using a secret way.

You can see a drawer (empty), a food pantry entrance on north, and a diner entrance on south here.

>s
diner
Now you are entering in the dinner room. Although there are six large windows, the room is kind of dark. There is a long table, a huge mirror and a fireplace. You should examine those.

You can see a huge mirror, a long table, a fireplace (in which is a Fireplace Tool), and a piano room entrance on west here.

>examine fireplace
(the fireplace)
In the fireplace is a Fireplace Tool.

You found a fireplace tool. Maybe you can open something using it.

>n
kitchen
You are seated at the table in the kitchen. Looking around You see some old fashioned furniture. You are exhausted, tired and thinking how to escape from the mansion using a secret way.

You can see a drawer (empty), a food pantry entrance on north, and a diner entrance on south here.

>n
food pantry
The Food Pantry is tight and has a closet and a red carpet on the floor. There is something under the carpet, You should examine it.

You can see a carpet and a closet here.

* * *

>examine
What do you want to examine?

>carpet
You can go through the secret access to scape the mansion by the secret place.

    *** The End ***

Would you like to RESTART, RESTORE a saved game, QUIT, or UNDO the last command?

* * *

>take
(the candle lantern)
Now You have everything to escape.

You are going down the stairs slowly worried about Don, but He is not here any more. Now You are on first floor, look for the secret way to go outside of the mansion.

piano room
The piano room is large, sort of dark, old fashioned sofas around the piano and some equipment for magician on the corners of the room.

You can see Don here.

Taken.

>n
You can't go that way.

* * *

>s
You can't go that way.

>e
Don found You. He is possessed by Mr. Carmo...  You should avoid him!!!

    *** By the time, you should have already taken all objects to escape. Mission Failed! ***

Would you like to RESTART, RESTORE a saved game, QUIT, or UNDO the last command?

* * *

>talk to don
I will take you to.... Follow me now... I will take You to... I don't need to explain.Come on! 

Do You follow him or push him?

>push him
Don fell down and seems to be passed out... run! Its time to run away.

You climbed up the stairs to second floor. Now You are in the middle of the hallway with 6 doors, none of them is opened.

When You turned around, You tripped over on a candle lantern.

Hallway
The hallway has six rooms and candle lanterns on the wall.

You can see a candle lantern here.

>examine
(the candle lantern)
You can lit the candle lantern and use it in the dark.

>take
(the candle lantern)
Now You have everything to escape. Find the secret way to outside of the mansion.

>s
You can't go that way.

* * *

>w
You can't go that way.

>e
You can't go that way.

>n
You can't go that way.

>down]
That's not a verb I recognize.

>down
You can't go that way.

* * *

>w
You bumped into Don... He is nervous, has red eyes and is angry. You should talk to Don.

piano room
The piano room is large, sort of dark, old fashioned sofas around the piano and some equipment for magician on the corners of the room.

You can see Don here.

>talk to him
I'm not sure what 'him' refers to.

>talk to don
I will take you to.... Follow me now... I will take You to... I don't need to explain.Come on! 

Do You follow him or push him?

* * *

>push him
Don fell down and seems to be passed out... run! Its time to run away.

You climbed up the stairs to second floor. Now You are in the middle of the hallway with 6 doors, none of them is opened.

When You turned around, You tripped over on a candle lantern.

Hallway
The hallway has six rooms and candle lanterns on the wall.

You can see a candle lantern here.

>take
(the candle lantern)
You already have that.

* * *

>w
You bumped into Don... He is nervous, has red eyes and is angry. You should talk to Don.

piano room
The piano room is large, sort of dark, old fashioned sofas around the piano and some equipment for magician on the corners of the room.

You can see Don here.

>talk to
(yourself)
You doesn't reply.

>talk to Don
You can't see any such thing.

* * *

>w
You bumped into Don... He is nervous, has red eyes and is angry. You should talk to Don.

piano room
The piano room is large, sort of dark, old fashioned sofas around the piano and some equipment for magician on the corners of the room.

You can see Don here.

>w
You can't go that way.

* * *

>e
diner
Now you are entering in the dinner room. Although there are six large windows, the room is kind of dark. There is a long table, a huge mirror and a fireplace. You should examine those.

You can see a huge mirror, a long table, a fireplace (in which is a Fireplace Tool), and a piano room entrance on west here.

>w
piano room
The piano room is large, sort of dark, old fashioned sofas around the piano and some equipment for magician on the corners of the room.

* * *

>s
diner
Now you are entering in the dinner room. Although there are six large windows, the room is kind of dark. There is a long table, a huge mirror and a fireplace. You should examine those.

You can see a huge mirror, a long table, a fireplace (in which is a Fireplace Tool), and a piano room entrance on west here.

I beg your pardon?

>s
You can't go that way.

* * *

>s
diner
Now you are entering in the dinner room. Although there are six large windows, the room is kind of dark. There is a long table, a huge mirror and a fireplace. You should examine those.

You can see a huge mirror, a long table, a fireplace (in which is a Fireplace Tool), and a piano room entrance on west here.

>talk
(to yourself)
You doesn't reply.

* * *

>s
diner
Now you are entering in the dinner room. Although there are six large windows, the room is kind of dark. There is a long table, a huge mirror and a fireplace. You should examine those.

You can see a huge mirror, a long table, a fireplace (in which is a Fireplace Tool), and a piano room entrance on west here.

>talk to Don
You can't see any such thing.

>w
You bumped into Don... He is nervous, has red eyes and is angry. You should talk to Don.

>talk
(to yourself)
You doesn't reply.

* * *

>talk to Don
You can't see any such thing.

>e]
That's not a verb I recognize.

>e
diner
Now you are entering in the dinner room. Although there are six large windows, the room is kind of dark. There is a long table, a huge mirror and a fireplace. You should examine those.

You can see a huge mirror, a long table, a fireplace (in which is a Fireplace Tool), and a piano room entrance on west here.

>w
You bumped into Don... He is nervous, has red eyes and is angry. You should talk to Don.

>tlk to Don
That's not a verb I recognize.

>e
diner
Now you are entering in the dinner room. Although there are six large windows, the room is kind of dark. There is a long table, a huge mirror and a fireplace. You should examine those.

You can see a huge mirror, a long table, a fireplace (in which is a Fireplace Tool), and a piano room entrance on west here.

* * *

>w
You bumped into Don... He is nervous, has red eyes and is angry. You should talk to Don.

>talk to Don
You can't see any such thing.

* * *

>open
What do you want to open?

>Drawer
You found a Matchbox. It will be useful in another moment.

>open
What do you want to open?

>Matchbox
Now you are entering in the living room.

* * *

>Drawer
You found a Matchbox. It will be useful in another moment.

>n
Food Pantry
The Food Pantry is tight and has a closet and a red carpet on the floor. There is something under the carpet.

You can see a Carpet and a Closet here.

>move
What do you want to move?

* * *

>open
What do you want to open?

>drawer
You found a matchbox. It will be useful in another moment.

You open the drawer.

>Drawer
That's not a verb I recognise.

>open The Drawer
Now you are entering in the living room.

* * *

>drawer
You found a matchbox. It will be useful in another moment.

You open the drawer.

>examine
(the matchbox)
The metchbox will be useful when everything is dark...

* * *

>drawer
You found a matchbox. It will be useful in another moment.

You open the drawer.

>s
diner
Now you are entering in the dinner room. Although there are six large windows, the room is kind of dark. There is a long table, a huge mirror and a fireplace. You should examine those.

You can see a huge mirror, a long table, a fireplace (in which is a Fireplace Tool), and a piano room entrance on west here.

>go
You'll have to say which compass direction to go in.

>piano room
That's not a verb I recognize.

>go piano room
That's not something you can enter.

>w
piano room
The piano room is large, sort of dark, old fashioned sofas around the piano and some equipment for magician in the corners of the room.

>climb
(the matchbox)
Little is to be achieved by that.

>up
You can't go that way.

>stairs
That's not a verb I recognize.

>go stairs
That's not something you can enter.

>climb
(the matchbox)
Little is to be achieved by that.

* * *

>s
diner
Now you are entering in the dinner room. Although there are six large windows, the room is kind of dark. There is a long table, a huge mirror and a fireplace. You should examine those.

You can see a huge mirror, a long table, a fireplace (in which is a Fireplace Tool), and a piano room entrance on west here.

>w
piano room
The piano room is large, sort of dark, old fashioned sofas around the piano and some equipment for magician in the corners of the room.

>go up
You can't go that way.

>climb
(the matchbox)
Little is to be achieved by that.

>climb the stairs
Little is to be achieved by that.

>up the stairs
I only understood you as far as wanting to (go) up.

>up
You can't go that way.

>climb up
You must name something more substantial.

>climb up the stairs
Little is to be achieved by that.

* * *

>w
piano room
The piano room is large, sort of dark, old fashioned sofas around the piano and some equipment for magician in the corners of the room.

>look
piano room
The piano room is large, sort of dark, old fashioned sofas around the piano and some equipment for magician in the corners of the room.

>climb
(the matchbox)
Little is to be achieved by that.

* * *

>up
You can't go that way.

>down
You can't go that way.

* * *

>drawer
You found a matchbox. It will be useful in another moment.

You open the drawer.

>n
food pantry
The Food Pantry is tight and has a closet and a red carpet on the floor. There is something under the carpet, You should examine it.

You can see a carpet and a closet here.

>carpet
That's not a verb I recognize.

>examine carpet
You found a sercret way, but the secret access to go through is locked. You need something to open it.

You see nothing special about the carpet.

>s
kitchen
You are seated at the table in the kitchen. Looking around You see some old fashioned furniture. You are exhausted, tired and thinking how to escape from the mansion using a secret way.

You can see a drawer (empty), a food pantry entrance on north, and a diner entrance on south here.

>w
You can't go that way.

>s
diner
Now you are entering in the dinner room. Although there are six large windows, the room is kind of dark. There is a long table, a huge mirror and a fireplace. You should examine those.

You can see a huge mirror, a long table, a fireplace (in which is a Fireplace Tool), and a piano room entrance on west here.

* * *

>examine fireplace
(the fireplace)
In the fireplace is a Fireplace Tool.

You found a fireplace tool. Maybe you can open something using it.

>w
You bumped into Don... He is nervous, has red eyes and is angry. You should talk to Don.

>talk to don
I will take you to.... Follow me now... I will take You to... I don't need to explain.Come on! 

Do You follow him or push him?

>push
What do you want to push?

>don
What do you want to don?

>push him
Don fell down and seems to be passed out... run! Its time to run away.

You climbed up the stairs to second floor. Now You are in the middle of the hallway with 6 doors, none of them is opened.

When You turned around, You tripped over on a candle lantern.

Hallway
The hallway has six rooms and candle lanterns on the wall.

You can see a candle lantern here.

>examine
What do you want to examine?

>candle lantern
You can lit the candle lantern and use it in the dark.

>take
What do you want to take?

>candle lantern
You already have that.

>s
You can't go that way.

* * *

>n
You can't go that way.

>e
You can't go that way.

* * *

>open
What do you want to open?

>n
food pantry
The Food Pantry is tight and has a closet and a red carpet on the floor. There is something under the carpet, You should examine it.

You can see a carpet and a closet here.

>examine carpet
You found a sercret way, but it is locked. You need something to open it.

>s
Kitchen
You are seated at the table in the kitchen. Looking around You see some old fashion furniture.

You can see a Drawer (in which is a Matchbox) here.

>s
Living Room
Now you are entering in the living room. Although there are six large windows, the room is kind of dark. There is a long table, a huge mirror and a fireplace. You should examine those.

You can see a Fireplace (in which is Yhe Fireplace Tool), a Huge Mirror and a Long Table here.

>examine Fireplace
You found a sercret way, but it is locked. You need something to open it.

* * *

>s
Living Room
Now you are entering in the living room. Although there are six large windows, the room is kind of dark. There is a long table, a huge mirror and a fireplace. You should examine those.

You can see a Fireplace (in which is Yhe Fireplace Tool), a Huge Mirror and a Long Table here.

>examine fireplace
(the Fireplace)
You found a sercret way, but it is locked. You need something to open it.

>get
What do you want to get?

>fireplace tool
Taken.

>examine mirror
You found a sercret way, but it is locked. You need something to open it.

>examine huge mirror
You found a sercret way, but it is locked. You need something to open it.

* * *

>s
Living Room
Now you are entering in the living room. Although there are six large windows, the room is kind of dark. There is a long table, a huge mirror and a fireplace. You should examine those.

You can see a Fireplace (in which is Yhe Fireplace Tool), a Huge Mirror and a Long Table here.

>examine mirror
You found a sercret way, but it is locked. You need something to open it.

>examine table
You found a sercret way, but it is locked. You need something to open it.

* * *

>examine
What do you want to examine?

>carpet
You found a sercret way, but the secret access to go through is locked. You need something to open it.

>s
kitchen
You are seated at the table in the kitchen. Looking around You see some old fashion furniture.

You can see a drawer (in which is a matchbox) here.

>s
diner
Now you are entering in the dinner room. Although there are six large windows, the room is kind of dark. There is a long table, a huge mirror and a fireplace. You should examine those.

You can see a huge mirror, a long table, and a fireplace (in which is a Fireplace Tool) here.

>examine
What do you want to examine?

>table
You found a sercret way, but it is locked. You need something to open it.

>fireplace
That's not a verb I recognise.

>examine fireplace
(the Fireplace)
You found a sercret way, but it is locked. You need something to open it.

>examine the fireplace
(the Fireplace)
You found a sercret way, but it is locked. You need something to open it.

>examine mirror
You found a sercret way, but it is locked. You need something to open it.

* * *

>examine
What do you want to examine?

>mirror
You see nothing special about the huge mirror.

Facing the mirror nothing different happened. When You turned around to the north of the dinner room, your image on the mirror frozen.

>examine huge mirror
You can't see any such thing.

>examine long table
You can't see any such thing.

* * *

>mirror
You see nothing special about the huge mirror.

Facing the mirror nothing different happened. When You turned around to the north of the dinner room, your image on the mirror frozen.

>examine
What do you want to examine?

>table
You see nothing special about the long table.

You see a long, brown and very clean table with ten beautiful chairs.

>examine
What do you want to examine?

>fireplace
(the fireplace)
In the fireplace is a Fireplace Tool.

You found a fireplace tool. Maybe you can open something using it.

>n
kitchen
You are seated at the table in the kitchen. Looking around You see some old fashion furniture.

You can see a drawer (in which is a matchbox) here.

>n
food pantry
The Food Pantry is tight and has a closet and a red carpet on the floor. There is something under the carpet, You should examine it.

You can see a carpet and a closet here.

>examine
(the Fireplace Tool)
You see nothing special about the Fireplace Tool.

>examine carpet
You can go through the secret access to scape the mansion by the secret place... You are free!!!

    *** The End ***

Would you like to RESTART, RESTORE a saved game, QUIT, or UNDO the last command?

* * *

>fireplace
(the fireplace)
In the fireplace is a Fireplace Tool.

You found a fireplace tool. Maybe you can open something using it.

>examine
(the Fireplace Tool)
You see nothing special about the Fireplace Tool.

>examine
(the Fireplace Tool)
You see nothing special about the Fireplace Tool.

* * *

>open
What do you want to open?

>s
You must name something more substantial.

>drawer
That's not a verb I recognize.

>open
What do you want to open?

* * *

>Drawer
That's not a verb I recognise.

>open
What do you want to open?

>drawer
You found a Matchbox.

* * *

>open drawer
You found a Matchbox. It will be useful in another moment.

>n
Food Pantry
The Food Pantry is tight and has a closet and a red carpet on the floor. There is something under the carpet, You should examine it.

You can see a Carpet and a Closet here.

* * *

>examine carpet
You found a sercret way, but it is locked. You need something to open it.

>s
Kitchen
You are seated at the table and The kitchen is very large with some old fashioned furniture.

You can see a Drawer (in which is a Matchbox) and a Brown Door here.

>open
What do you want to open?

>door
You found a Matchbox. It will be useful in another moment.

>open
What do you want to open?

>brown door
You found a Matchbox. It will be useful in another moment.

>open Brown Door
You found a Matchbox. It will be useful in another moment.

* * *

>s
Kitchen
You are seated at the table and The kitchen is very large with some old fashioned furniture.

You can see a Drawer (in which is a Matchbox) and a Brown Door here.

>enter door
Now you are entering in the living room. Although there are six large windows, the room is kind of dark. There is a long table, a huge mirror and a lit fireplace. You should examine those.

>examine
What do you want to examine?

>fireplace
You can't see any such thing.

>examine
What do you want to examine?

>lit fireplace
You can't see any such thing.

>examine mirror
You can't see any such thing.

>see fireplace
That's not a verb I recognise.

>look fireplace
You can't see any such thing.

* * *

>s
Kitchen
You are seated at the table and The kitchen is very large with some old fashioned furniture.

You can see a Drawer (in which is a Matchbox) and a Brown Door here.

>s
(first opening the Brown Door)
You found a Matchbox. It will be useful in another moment.

>enter door
Now you are entering in the living room. Although there are six large windows, the room is kind of dark. There is a long table, a huge mirror and a lit fireplace. You should examine those.

* * *

>examine
What do you want to examine?

>huge mirror
You can't see any such thing.

>examine fireplace
You can't see any such thing.

* * *

>n
You can't go that way.

>s
Kitchen
You are seated at the table and The kitchen is very large with some old fashioned furniture.

You can see a Drawer (in which is a Matchbox) and a Brown Door here.

>enter
You must supply a noun.

>enter door
Now you are entering in the living room.

* * *

>open drawer
You found a Matchbox. It will be useful in another moment.

>enter door
Now you are entering in the living room. Although there are six large windows, the room is kind of dark. There is a long table, a huge mirror and a lit fireplace. You should examine those.

* * *

>fireplace
You can't see any such thing.

>examine huge mirror
You can't see any such thing.

* * *

>opr=en
That's not a verb I recognise.

>open
(the Drawer)
You found a Matchbox. It will be useful in another moment.

>n
Food Pantry
The Food Pantry is tight and has a closet and a red carpet on the floor. There is something under the carpet, You should examine it.

You can see a Carpet and a Closet here.

>exmaine
That's not a verb I recognise.

>examine
What do you want to examine?

* * *

>carpet
You found a sercret way, but it is locked. You need something to open it.

>s
Kitchen
You are seated at the table and The kitchen is very large with some old fashioned furniture.

You can see a Drawer (in which is a Matchbox) here.

>s
Living Room
Now you are entering in the living room. Although there are six large windows, the room is kind of dark. There is a long table, a huge mirror and a lit fireplace. You should examine those.

You can see a Fire Place, a Huge Mirror and a Long Table here.

>examine
What do you want to examine?

>Fire Place
You found a sercret way, but it is locked. You need something to open it.

>examine
What do you want to examine?

* * *

>fireplace
You can't see any such thing.

>look at
What do you want to look at?

>mirror
You found a sercret way, but it is locked. You need something to open it.

>Don
What do you want to don?

>know
You can't see any such thing.

>who is Don
That's not a verb I recognise.

>introduce Don
That's not a verb I recognise.

* * *

>opoen
That's not a verb I recognize.

>open
(the drawer)
You found a matchbox. It will be useful in another moment.

>n
food pantry
The Food Pantry is tight and has a closet and a red carpet on the floor. There is something under the carpet, You should examine it.

You can see a carpet and a closet here.

>examine closet
You see nothing special about the closet.

>examine carpet
You found a sercret way, but the secret access to go through is locked. You need something to open it.

>s
kitchen
You are seated at the table in the kitchen. Looking around You see some old fashion furniture.

You can see a drawer (in which is a matchbox) here.

* * *

>s
diner
Now you are entering in the dinner room. Although there are six large windows, the room is kind of dark. There is a long table, a huge mirror and a fireplace. You should examine those.

You can see a huge mirror, a long table, and a fireplace (in which is a Fireplace Tool) here.

>examine mirror
You see nothing special about the huge mirror.

Facing the mirror nothing different happened. When You turned around to the north of the diner, your image on the mirror frozen.

>examine huge mirror
You see nothing special about the huge mirror.

Facing the mirror nothing different happened. When You turned around to the north of the diner, your image on the mirror frozen.

>examine long table
You see nothing special about the long table.

You see a long, brown and very clean table with ten beautiful chairs.

>examine fireplace
(the fireplace)
In the fireplace is a Fireplace Tool.

You found a fireplace tool. Maybe you can open something using it.

>n
kitchen
You are seated at the table in the kitchen. Looking around You see some old fashion furniture.

You can see a drawer (in which is a matchbox) here.

* * *

>n
food pantry
The Food Pantry is tight and has a closet and a red carpet on the floor. There is something under the carpet, You should examine it.

You can see a carpet and a closet here.

>examine carpet
You can go through the secret access to scape the mansion by the secret place... You are free!!!

    *** The End ***

Would you like to RESTART, RESTORE a saved game, QUIT, or UNDO the last command?

* * *

>go food pantry
That's not something you can enter.